9.oX
.........
.....o...
.........
.......o.
o........
...o.....
.........
.........
........o
